##################################################
##     #######          ##########################
##     #####!    @ ####           ################
##     ######      #### !         ################
#### ############# ####           ################
#### ##     ###### ####           ################
####               #### ######### ################
#######     ###########   #####   ################
#######     ###########   #####   ################
#######     ###########   #####   ################
#######      ##########   #####              ! ###
############ #####################################
####      ## #####################################
####      ## #####################################
####         #####################################
####         #####################################
####         #####################################
#### # # # # #####################################
####         #####################################
#### # # # # ############### >                   #
####         ###############                     #
#### # # # # ###############                     #
####                                             #
##################################################
