##################################################################################
############################################   @               ###################
############################################                   ###################
############################################                   ###################
############################################                   ###################
############################################                   ###################
##################################################### ############################
##################################################### ############################
#####################################################  ###########################
######################################################  ##########################
#######################################################  #########################
########################################################  ########################
######################################################### ########################
#########################################################  #######################
########################################################## #######################
########################################################## #################     #
#####          ##########################################  #################     #
#####          ########################################## ##################     #
#####          ########################################## ##################     #
#####          ########################################## ##################     #
#####          ########################################## ##################     #
#####          ########################################## #######       ####     #
#####          ########################################## #######       ####     #
#####          #           ############################## #######       ####>    #
#####             ##### ## ############################## #######                #
#####          ## ##### ## ############################## #######       ####     #
#####          ##  #### ## ############################## #######       ####     #
#####          ### ##      ############################## #######       ##########
#####          ###    # #   ############################# #######       ##########
#####          ######## #   ############################  #######       ##########
##########        ##### #   ############################ ########       ##########
##########        ##        ######################                      ##########
##########        ##   ##  #######################                      ##########
##########                   #####################                      ##########
#<                           #####################                      ##########
##########                   #####################                      ##########
##########                   #####################                  ##############
##########                   #####################                  ##############
##########                   #####################                  ##############
############                 ##           ######## ############ ##################
############                 ##           ######## ##########   ##################
############                              ######## ########## ####################
############                 #            #######  ########## ####################
############                 ##                   #######     ####################
############                 ##           # #####         ########################
############                 ##           # ######################################
############                 ##           # ######################################
###################  ##### ####           # ######################################
#################### ##### ####           # ######################################
#################### ###   ####           # ######################################
####################  ## ######           #  #####################################
#####################    ######           ##       ###############################
#######################   ######################## ###############################
######################### #################        ###############################
#####       #############    #########    #        ###############################
#####       ################  ########    #        ###############################
#####       #################   ######    #        ###############################
#####       ###################           #        ###############################
#####       ################### ######    #        ###############################
#####       ################### ######    #        ###############################
#####       ################### ######    #        ###############################
#####       #######    ######## ######    #        ###############################
#####               ##          ######    #        ###############################
#####       ######################################################################
#####       ######################################################################
#####       ######################################################################
#####       ######################################################################
##################################################################################
