##################################################
##     #######          ##########################
##     #####     @ ####           ################
##     ######      ####           ################
#### ############# ####           ################
#### ##     ###### ####           ################
####               #### ######### ################
#######     ###########   #####   ################
#######     ###########   #####   ################
#######     ###########   #####   ################
#######     ###########   #####              ! ###
##################################################
##################################################
##################################################
##################################################
##################################################
##################################################
##################################################
