##################################################
##     #######          ##########################
##     #####     @ ####           ################
##     ######      ####           ################
#### ############# ####           ################
#### ##    ####### ####           ################
####               #### ######### ################
#######    ############   #####   ################
#######################   #####   ################
#######################   #####   ################
#######################   #####              ! ###
##################################################
##################################################
##################################################
##################################################
##################################################
##################################################
##################################################
